111111111111111111111111
111111111111100000000001
111111111111100001000001
111111111111100001000001
111111111111100001111111
111111111111100001111111
110000000000000001111111
110000000000000001111111
113000010011111111111111
111111111111111111111111